111111111111111111111111111111
1P0000000000000000000000000001
10000000000C00000C000000000001
1000000000000000000000000000E1
111111111111111111111111111111