1111111111111
1P00000000001
1000C00C00001
1000000000001
100C000C000E1
1111111111111