1111111111111
1P00000000001
1111110000001
1000000011101
100C000000001
1011111111101
100000000C001
1011111111101
1000000000001
100C000000E01
1111111111111