1111111111111111111111
1P000001000000000000E1
1011111011111111111101
1010001000000000000001
1010101111111111110101
1010100000C00000010101
1010111111111111000101
10100000000000C0010101
1011111111111111010101
1000000000000000010101
1111111111111111110101
1C00000000000000000101
1111111111111111111111