1111111111
1P00C0C001
1C00000C01
10C0000001
1000C000E1
1111111111