1111111111111111111111111111111111
10E000000000000C00100C000000000001
1000010100100000101001000000010101
11100100101010100010010000000101P1
100000000C00C0000010000000000000C1
1111111111111111111111111111111111