1111111111111111111111111111111111
1010E0000000000C00100C000000000001
1001010100100000100000000000010101
11100100101010100010010000000101P1
100000000C00C0000010000000000000C1
1111111111111111111111111111111111