11111111
1P000C01
10000001
1E100001
11111111