11111111111
1P0000000E1
11111111101
1000000C101
11111111111