1111111111
1P00000001
0000C00001
1000000E01
1111111111