1111111111
11P1111111
1111C11111
11111E1111
1111111111